1111111111111111111111
100000C000100000000001
10P0100100000E00000001
10000000001000000C0001
1111111111111111111111