1111111111111111111111
10000CC000100000000001
1000100100000E00000001
1000P00000100000000001
1111111111111111111111