1111111111111111
1001C10000000001
100101000P000E01
10C0000000000001
1111111111111111