1111111111111111111111
1000000000000000000001
1000000000000E00000001
1000000000000000000001
1000000000000000000001
10000000C0000000000001
1000000000000000000001
1000100100000P00000001
1000000000100000000001
1111111111111111111111