1111111111111111
1001C10000000001
100101000P001E01
10C0000111001111
10000001C1000001
1000000101000001
1000000000111111
10000000000000C1
1111111111111111